#######
#.....#
#.###.#
#..X#.#
#.###A#
#...#.#
#...#.#
#...#.#
#.....#
#.....#
#...#.#
#.@.#.#
#...#C#
#######