* **********
*      *****
*** **  ****
***   *  ***
**  * ** ***
*  ** ** ***
***** ******
*****   ****
****  * ****
*   **  ****
* *    *****
*** ********